-------------------------
-                       -
-                       -
--              ---------
-                       -
-                      *-
-      --       ------ --
-                       -
-                       -
-   --     -            -
-                   --- -
-                       -
-                       -
-    --   --     --     -
-                       -
-      -----------      -
-                       -
-                   --  -
- p                     -
-------------------------