-------------------------
-                       -
-                       -
-                   *   -
-               ---------
-                       -
-    -      --          -
-                       -
--                      -
-   --                  -
-                   --- -
-                       -
-                       -
-      ---              -
-                       -
-   -----------         -
-                       -
- --                --  -
- p                     -
-------------------------